border_size=1
usage=map

Ms^Xm       , Ms^Xm       , Ms^Xm       , Ms^Xm       , Ms^Xm       , Ms^Xm       , Ms^Xm       , Ms^Xm       , Ms^Xm       , Ms^Xm       , Gg          , Re          , Gg          , Ms^Xm       , Ms^Xm       , Ms^Xm       , Ms^Xm       , Ms^Xm       , Ms^Xm       , Ms^Xm       , Ms^Xm       , Ms^Xm       , Ms^Xm       , Ms^Xm       
Ms^Xm       , Ms^Xm       , Ms^Xm       , Ms^Xm       , Ms^Xm       , Ms^Xm       , Ms^Xm       , Ms^Xm       , Gg          , Gg          , Gg          , Re          , Gg          , Gg          , Gg          , Ha^Vhha     , Ms^Xm       , Ms^Xm       , Ms^Xm       , Ms^Xm       , Ms^Xm       , Ms^Xm       , Ms^Xm       , Ms^Xm       
Ms^Xm       , Ms^Xm       , Ms^Xm       , Ms^Xm       , Ms^Xm       , Ms^Xm       , Gg          , Gg          , Gg          , Gg          , Ce          , Ce          , Ce          , Gg          , Gg          , Gg          , Gg          , Ms^Xm       , Ha^Vhha     , Ms^Xm       , Ms^Xm       , Ms^Xm       , Ms^Xm       , Ms^Xm       
Ms^Xm       , Ms^Xm       , Ms^Xm       , Ms^Xm       , Gg          , Gg          , Gg          , Gg          , Gg          , Gs^Fds      , Ce          , 2 Kh        , Ce          , Ce          , Gg          , Gg          , Gg          , Gg          , Gg          , Ms^Xm       , Ms^Xm       , Ms^Xm       , Ms^Xm       , Ms^Xm       
Ms^Xm       , Ms^Xm       , Mm          , Hh          , Gg          , Gg          , Gg          , Gg          , Gg          , Gg          , Gg          , Ce          , Gg          , Gg          , Gg          , Gg          , Gg          , Gg          , Gg          , Gg          , Hh^Fms      , Ms^Xm       , Ms^Xm       , Ms^Xm       
Gg          , Hh^Fms      , Gg          , Gg          , Gg          , Gg          , Mm          , Gg          , Gs^Vh       , Gg          , Gg          , Re          , Gg          , Gg          , Gg          , Gg          , Gg          , Gg          , Gg          , Gg          , Gg          , Mm          , Hh          , Ms^Xm       
Gg          , Gg          , Gg          , Gg          , Gg          , Gs^Fds      , Gs          , Hh          , Gg          , Gg          , Gg          , Re          , Gg          , Gg          , Gg          , Mm          , Gg          , Gg          , Gg          , Gg          , Gg          , Gg          , Gg          , Gg          
Gg          , Gg          , Gg          , Gg          , Gg          , Gg          , Gg          , Gg          , Gg          , Gg          , Gg          , Re          , Gg          , Gg          , Gg          , Gg          , Gg          , Gg          , Gg          , Gg          , Gg          , Gg          , Gg          , Gg          
Gg          , Gs^Vc       , Gg          , Gg          , Gg          , Gg          , Gg          , Gg          , Gg          , Gs          , Hh^Fp       , Re          , Gg          , Gg          , Gg          , Gg          , Gg          , Gg          , Gg          , Gg          , Gg          , Gg          , Gg          , Gg          
Gg          , Gg          , Gg          , Gg          , Gs^Fds      , Gs^Fds      , Gg          , Gg          , Gg          , Gg          , Gg          , Re          , Gg          , Gg          , Gg          , Gg          , Hh^Fms      , Hh          , Hh^Fms      , Hh          , Gg          , Gg          , Hh          , Gg          
Gg          , Gg          , Gg          , Gs^Fds      , Gg^Ve       , Gs^Fds      , Gs^Fds      , Gg          , Gg          , Gg          , Gg          , Re          , Gg          , Gg          , Gg          , Hh          , Mm          , Mm^Xm       , Mm          , Mm          , Hh          , Hh          , Mm          , Hh          
Gg          , Gg          , Gg          , Gs^Fds      , Gg          , Gg          , Gg          , Gg          , Gg          , Gg          , Gs^Vh       , Re          , Gg          , Gg          , Gg          , Gg          , Hh          , Hh^Vhh      , Gg          , Hh          , Gg          , Gg          , Gg          , Gg          
Gg          , Gg          , Gg          , Gg          , Gg          , Gg          , Gg          , Gg          , Gg          , Gg          , Gg          , Re          , Gg          , Gg          , Gg          , Gg          , Gg          , Gg          , Gg          , Gg          , Gg          , Gg          , Gg          , Gg          
Gg          , Gg          , Gg          , Gg          , Gg          , Gg          , Ss^Vhs      , Gg          , Gg          , Gg          , Gg          , Re          , Gg          , Gg          , Gs^Fds      , Gg          , Gg          , Gg          , Ww^Ewl      , Gg          , Gg          , Gg          , Hh^Fp       , Hh^Fp       
Gg          , Gg          , Gg          , Gg          , Ss          , Ss          , Wog         , Ss          , Gs^Fds      , Gg          , Gg          , Re          , Gg          , Gg          , Gg          , Gg          , Gg          , Gg          , Gg          , Gg          , Gg          , Gg          , Gg          , Hh^Fp       
Gg          , Gg          , Gg          , Gg          , Ss          , Wwg         , Ss          , Ss          , Gg          , Gg          , Gg          , Re          , Gg^Vwm      , Gg          , Gg          , Gg          , Gg          , Gg          , Gg          , Gg          , Gg          , Gg          , Gg          , Gg          
Gg          , Gg          , Gg          , Gg          , Gg          , Wwf         , Gg          , Gg          , Gg          , Gg          , Gg          , Re          , Gg          , Gg          , Gg          , Mm          , Gs^Fds      , Gg          , Gg          , Gg          , Hh          , Gg          , Gg          , Gg          
Gg          , Gg          , Wwg         , Gg          , Gg          , Wwg         , Ww^Vm       , Gg          , Gg          , Gg          , Wwg         , Re          , Wwf         , Gg          , Wwg         , Wwg         , Wwg         , Gg          , Wwg         , Wwg         , Wwg         , Mm          , Wwg         , Wwg         
Wwg         , Wwg         , Mm          , Wwg         , Wwg         , Wwg         , Gg          , Wwg         , Wwg         , Wwg         , Gg          , Wwf         , Re          , Wwg         , Gg          , Gg          , Gg          , Ww^Vm       , Wwg         , Gg          , Gg          , Wwg         , Gg          , Gg          
Gg          , Gg          , Gg          , Hh          , Gg          , Gg          , Gg          , Gs^Fds      , Mm          , Gg          , Gg          , Gg          , Re          , Gg          , Gg          , Gg          , Gg          , Gg          , Wwf         , Gg          , Gg          , Gg          , Gg          , Gg          
Gg          , Gg          , Gg          , Gg          , Gg          , Gg          , Gg          , Gg          , Gg          , Gg          , Gg          , Gg^Vwm      , Re          , Gg          , Gg          , Gg          , Ss          , Ss          , Wwg         , Ss          , Gg          , Gg          , Gg          , Gg          
Hh^Fp       , Gg          , Gg          , Gg          , Gg          , Gg          , Gg          , Gg          , Gg          , Gg          , Gg          , Gg          , Re          , Gg          , Gg          , Gs^Fds      , Ss          , Wog         , Ss          , Ss          , Gg          , Gg          , Gg          , Gg          
Hh^Fp       , Hh^Fp       , Gg          , Gg          , Gg          , Ww^Ewl      , Gg          , Gg          , Gg          , Gs^Fds      , Gg          , Gg          , Re          , Gg          , Gg          , Gg          , Gg          , Ss^Vhs      , Gg          , Gg          , Gg          , Gg          , Gg          , Gg          
Gg          , Gg          , Gg          , Gg          , Gg          , Gg          , Gg          , Gg          , Gg          , Gg          , Gg          , Gg          , Re          , Gg          , Gg          , Gg          , Gg          , Gg          , Gg          , Gg          , Gg          , Gg          , Gg          , Gg          
Gg          , Gg          , Gg          , Gg          , Hh          , Gg          , Hh^Vhh      , Hh          , Gg          , Gg          , Gg          , Gg          , Re          , Gs^Vh       , Gg          , Gg          , Gg          , Gg          , Gg          , Gg          , Gs^Fds      , Gg          , Gg          , Gg          
Hh          , Mm          , Hh          , Hh          , Mm          , Mm          , Mm^Xm       , Mm          , Hh          , Gg          , Gg          , Gg          , Re          , Gg          , Gg          , Gg          , Gg          , Gs^Fds      , Gs^Fds      , Gg^Ve       , Gs^Fds      , Gg          , Gg          , Gg          
Gg          , Hh          , Gg          , Gg          , Hh          , Hh^Fms      , Hh          , Hh^Fms      , Gg          , Gg          , Gg          , Gg          , Re          , Gg          , Gg          , Gg          , Gg          , Gg          , Gs^Fds      , Gs^Fds      , Gg          , Gg          , Gg          , Gg          
Gg          , Gg          , Gg          , Gg          , Gg          , Gg          , Gg          , Gg          , Gg          , Gg          , Gg          , Gg          , Re          , Hh^Fp       , Gs          , Gg          , Gg          , Gg          , Gg          , Gg          , Gg          , Gg          , Gs^Vc       , Gg          
Gg          , Gg          , Gg          , Gg          , Gg          , Gg          , Gg          , Gg          , Gg          , Gg          , Gg          , Gg          , Re          , Gg          , Gg          , Gg          , Gg          , Gg          , Gg          , Gg          , Gg          , Gg          , Gg          , Gg          
Gg          , Gg          , Gg          , Gg          , Gg          , Gg          , Gg          , Gg          , Mm          , Gg          , Gg          , Gg          , Re          , Gg          , Gg          , Gg          , Hh          , Gs          , Gs^Fds      , Gg          , Gg          , Gg          , Gg          , Gg          
Ms^Xm       , Hh          , Mm          , Gg          , Gg          , Gg          , Gg          , Gg          , Gg          , Gg          , Gg          , Gg          , Re          , Gg          , Gg          , Gs^Vh       , Gg          , Mm          , Gg          , Gg          , Gg          , Gg          , Hh^Fms      , Gg          
Ms^Xm       , Ms^Xm       , Ms^Xm       , Hh^Fms      , Gg          , Gg          , Gg          , Gg          , Gg          , Gg          , Gg          , Gg          , Ce          , Gg          , Gg          , Gg          , Gg          , Gg          , Gg          , Gg          , Hh          , Mm          , Ms^Xm       , Ms^Xm       
Ms^Xm       , Ms^Xm       , Ms^Xm       , Ms^Xm       , Ms^Xm       , Gg          , Gg          , Gg          , Gg          , Gg          , Ce          , Ce          , 1 Kh        , Ce          , Gs^Fds      , Gg          , Gg          , Gg          , Gg          , Gg          , Ms^Xm       , Ms^Xm       , Ms^Xm       , Ms^Xm       
Ms^Xm       , Ms^Xm       , Ms^Xm       , Ms^Xm       , Ms^Xm       , Ha^Vhha     , Ms^Xm       , Gg          , Gg          , Gg          , Gg          , Ce          , Ce          , Ce          , Gg          , Gg          , Gg          , Gg          , Ms^Xm       , Ms^Xm       , Ms^Xm       , Ms^Xm       , Ms^Xm       , Ms^Xm       
Ms^Xm       , Ms^Xm       , Ms^Xm       , Ms^Xm       , Ms^Xm       , Ms^Xm       , Ms^Xm       , Ms^Xm       , Ha^Vhha     , Gg          , Gg          , Gg          , Re          , Gg          , Gg          , Gg          , Ms^Xm       , Ms^Xm       , Ms^Xm       , Ms^Xm       , Ms^Xm       , Ms^Xm       , Ms^Xm       , Ms^Xm       
Ms^Xm       , Ms^Xm       , Ms^Xm       , Ms^Xm       , Ms^Xm       , Ms^Xm       , Ms^Xm       , Ms^Xm       , Ms^Xm       , Ms^Xm       , Ms^Xm       , Gg          , Re          , Gg          , Ms^Xm       , Ms^Xm       , Ms^Xm       , Ms^Xm       , Ms^Xm       , Ms^Xm       , Ms^Xm       , Ms^Xm       , Ms^Xm       , Ms^Xm       
